                                 T     P           U       U       Z   O                                     
                                 H     Z           A       U       W   K                                     
  ###############################.#####.###########.#######.#######.###.###################################  
  #.#.#.#.#.............#.#...#.#.....#...#.....#.....#.....#...#.....#...#...#...#.#.......#.....#.......#  
  #.#.#.#.#####.#.#####.#.###.#.#.###.###.#.#.#.#.#.#.#.###.###.#.###.#.###.###.###.#####.#####.###.#.#####  
  #...#.........#.#...........#...#...#.#...#.#.#.#.#.#.#.#.....#...#.#.#...........#.#.#.#.#.......#...#.#  
  ###.###.###.#########.###.###.#####.#.#.###.#####.#.#.#.#####.#.#.#.#.#.#######.###.#.#.#.###.#########.#  
  #...#.#.#.......#.#.....#.....#.......#.#.#.#.#...#.#.#.#.#...#.#.#.#.......#.....#...#.#.#.#.....#.....#  
  ###.#.#####.###.#.#########.#.#.###.###.#.#.#.#####.#.#.#.#######.#.#.#.#############.#.#.#.#.###.#####.#  
  #.....#.....#.#.#...........#.#.#...#.#.#.......#...#.......#...#.#.#.#.#...#.#.#.#.#.........#.#...#...#  
  #.###.#####.#.#######.#####.#######.#.#####.#####.###.#.#.#####.###.#.###.###.#.#.#.#.#########.#####.###  
  #.#.#.#...#.#.....#.#.#.#...#...#.......#.#...#.....#.#.#.....#.....#.............................#.....#  
  ###.#.#.#####.#####.###.###.#.###.#.#.###.#.#####.#.###.#.#.#.#####.###.#######.###.###.#.###.#.###.#####  
  #.........#.#...#.#.......#.#...#.#.#.#.....#.....#.#...#.#.#.#...#.#...#.#...#.#.#.#...#...#.#.#.....#.#  
  #####.#####.#.###.#####.#.###.#.###.###.###.#.###.###.#####.#####.#.#.#.#.#.#####.#####.###########.###.#  
  #.#.#...#.#.....#...#...#.....#.#.....#.#...#...#...#.#.#.#.#...#.#.#.#...#.#.......#...........#.#.#.#.#  
  #.#.#.###.#.#####.###.#########.#.#.#######.###.#.#####.#.#.#.#.###.#.#####.#.#.#.#####.#.#.#.###.#.#.#.#  
  #.....#.....#.#.#...#.#...#.....#.#...#.....#...#...#...#.#.#.#.#...#.#.......#.#.#...#.#.#.#.#...#.....#  
  ###.###.#.#.#.#.#.#######.#####.###.#####.###.#.#######.#.#.#.#.#.#.#.#.###.#######.#########.#.#####.###  
  #...#.#.#.#.#.#...#...#.....#...#.....#.#...#.#.#.#.......#.#.#.#.#.#...#.#...#...#.#.....#...#.....#.#.#  
  ###.#.#####.#.###.#.#######.###.###.###.###.#.###.###.#.###.#.#.#.###.###.#.###.#.#.#.#########.#.###.#.#  
  #.....#.#.......#.#...#.....#.#.......#...#.#.....#.#.#.....#.#.#...#.#.........#.....#.#...#.#.#.....#.#  
  ###.#.#.###.#####.#.#####.#.#.#.#.#.###.#.#.#.#####.#.#.###.#.#.###.#.###.#############.#.###.###.#.#.#.#  
  #.#.#.#.#.......#.#.#...#.#...#.#.#.#.#.#.#.#.......#.#.#...#.#...#.#.#...#...#.....#.....#.#...#.#.#.#.#  
  #.#.###.#####.###.#.###.#####.#.#####.#.###.#####.#.#.#######.###.#.###.###.###.#########.#.#.#.#####.#.#  
  #.......#...#...#...#.#.........#...........#.....#.#.......#...#.....#.........#...#.....#.#.#...#.#...#  
  ###.#.###.###.#.###.#.#######.#######.#######.#############.###.###########.#######.###.#.#.###.###.#.###  
  #.#.#...#...#.#.....#...#    Y       R       R             U   X           L    #.....#.#.#.#...#.#...#.#  
  #.#####.#.#######.#####.#    O       F       U             A   Z           Q    #.#.#####.#.###.#.###.#.#  
  #.#.#.#...#...#.....#.#.#                                                       #.#.#.........#...#.....#  
  #.#.#.###.#.#####.#.#.#.#                                                       ###.#.#.#.#.###.#####.###  
RF........#...#.#.#.#......TH                                                     #.#.#.#.#.#.....#.......#    
  #.#######.###.#.#####.###                                                       #.#.#######.###.###.#.###  
BN......#...#.#.#.#.#......ER                                                   BH........#.#.#...#...#.#.#  
  #.#.#####.#.#.#.#.#.###.#                                                       #####.###.#.#######.###.#  
  #.#.#.#...........#.#...#                                                       #.....#.#.#.#.#...#.....#  
  #.###.#.#####.###.###.###                                                       ###.###.#.#.#.###.#.#####  
  #.......#.#.#.#.......#.#                                                       #...#.#.#.#...#.......#..LP
  #######.#.#.#######.###.#                                                       ###.###.#.#.#####.#.###.#  
ON..#.#.#.#.......#.#.#...#                                                       #.#...............#.....#  
  #.#.#.#.###.###.#.#####.#                                                       #.#######################  
  #.#...#.#.....#.........#                                                       #.......................#  
  #.#.#.#####.###.###.###.#                                                       #.#####.#.#.#.#.#####.###  
  #.#.#.....#...#...#.#....CU                                                     #...#...#.#.#.#.#.#...#..CU
  #.#.#.###.#.###.#######.#                                                       #.#####.#.#######.#.###.#  
  #...#.#.....#.#.#...#...#                                                       #.#...#.#.....#.#...#...#  
  ###.#########.#####.#.#.#                                                       #.#.#######.#.#.###.###.#  
YO..#.#.#.#...#.....#.#.#.#                                                     BT..#.....#.#.#.#...#.....#  
  #.###.#.#.#.#.#.###.#####                                                       #.###.###.#######.#######  
  #.........#...#..........UK                                                     #.#.....#.............#..GR
  #.#.###.#.###.###########                                                       ###.#.#####.#########.#.#  
  #.#.#...#...#.#.....#...#                                                       #...#.......#.#...#.....#  
  ###.#########.#.#####.#.#                                                       #.###.#.#.#.#.#.#####.###  
ZH..#...#.#...#.#.#...#.#..GR                                                   OK....#.#.#.#.#.#.#.#...#.#  
  #.#####.###.###.#.#.#.###                                                       #############.#.#.#####.#  
  #.................#...#.#                                                       #.#...#...#.#............KP
  #######################.#                                                       #.#.###.#.#.#.#######.###  
  #.......................#                                                     RK..#.....#.........#.....#  
  ###.#####.#.#.#######.###                                                       #.#.#######.#######.#.###  
BT..#.#...#.#.#.#.....#.#..BN                                                     #.....#...#.#.#...#.#...#  
  #.#.#.#.#####.#.#.###.#.#                                                       #####.###.###.###.#######  
  #.#...#.#...#.#.#.....#.#                                                       #.#.#.#.............#...#  
  #.#####.#.#####.#######.#                                                       #.#.#.#.#.###.#.#######.#  
  #.......#.#.#.#.........#                                                     ON....#.#.#.#...#.#...#....LW
  #########.#.#.###########                                                       #.#####.#######.###.###.#  
  #...............#........ZW                                                     #.#.........#.........#.#  
  #.#.#.###.###.#.###.#####                                                       #.#####.#############.#.#  
UK..#.#.#.#.#...#.#...#...#                                                       #.........#...#.#.#.....#  
  #.#.###.#####.#.###.#.###                                                       #############.#.#.###.###  
  #.#.#.....#.#.#.#.......#                                                       #.............#...#...#.#  
  ###.#.###.#.###.#.#######                                                       #.###.#.#.###.#.#.#####.#  
  #.#.#.#.#...#.#.....#...#                                                       #...#.#.#...#...#.....#..IG
  #.#####.###.#.#######.###                                                       #.#.###.#####.#.#.###.#.#  
  #.......#.............#.#                                                       #.#.#.#.#.....#.#...#...#  
  ###.#.###.#.#.###.###.#.#                                                       #.###.#.#.#.#########.#.#  
LQ....#...#.#.#...#.#...#..UU                                                   PZ......#.#.#...#.......#.#  
  #.#######.###.#.#####.#.#                                                       #.###.#########.###.#####  
ZZ............#.#.#.#...#.#                                                       #.#.#.......#...#.....#.#  
  #.#.#.#.#.#######.###.#.#                                                       #.#.#.#####.#.#####.###.#  
  #.#.#.#.#.........#.....#                                                       #.#.....#...#.#.........#  
  #.#.###.#.#.###.#.#.#.#.#    L     K           Z     L     E       A       I    #.###.#####.#####.#.#.#.#  
  #.#...#.#.#.#...#.#.#.#.#    W     P           H     P     G       U       G    #.#.....#.#...#...#.#.#.#  
  #.#######.#####.#.#####.#####.#####.###########.#####.#####.#######.#######.###########.#.###.#.###.#.###  
  #.#.........#...#.#.......#.....#.#.....#.......#.......#...#.#...#.#.#.#...#.......#.#.#.#...#...#.#...#  
  #.###.###.###.#####.#######.###.#.#.###.#.###.###.###.###.###.#.#.#.#.#.###.#.###.###.#.#.###.###.###.###  
  #.#...#.....#.#.#.#.#.........#...#.#.#.#.#.#...#...#.#...#.....#.#...#.#.......#.#.........#.#...#.#...#  
  #.###.###.#####.#.###.#.#.#.#########.#.#.#.#####.###.###.###.###.#.###.###.###########.#.###.#####.#.###  
  #...#.#...#.......#.#.#.#.#.#.#.....#...#.......#...#.#.....#.#.....#...#...#.#...#.#...#...#.#.......#.#  
  #####.###.#####.#.#.#.###.#.#.#####.#.#.###.#####.#########.#.###.#.#.#.#.###.#.###.###.#.#.#.###.#.#.#.#  
  #.....#...#.#...#.....#...#.......#...#.#.......#.........#.#...#.#.#.#...#...#.#.....#.#.#.#...#.#.#...#  
  #.#.#.#.#.#.#.#####.#########.###.#.###.#.#######.###.#####.#.#####.#####.###.#.###.#.#.###.#.#######.###  
  #.#.#.#.#...#.#.....#.#.#.#.....#.#...#.#.#.#.#.#...#.#.....#.....#.#...#...........#.#.#.#.#.#...#.#...#  
  #.#######.#.#########.#.#.#.#.#########.#.#.#.#.#####.###.#.#.#########.#.#.###.###.#####.###.###.#.#.###  
  #.#.#.#...#...#.............#...#.#.....#.#.#...#.....#...#.#.....#.#.....#.#.#.#...#.#.#...#.#...#.#...#  
  #.#.#.###.#.#######.#.###.#.#####.#####.#.#.#.#####.#.###.###.###.#.###.#.###.#.#####.#.###.###.###.#####  
  #.#.....#.#.#.#.....#.#...#.....#...#...#.......#.#.#...#...#...#.#.#...#.....#.#...#.#.................#  
  #####.###.###.#####.###.#.###.###.#####.#####.#.#.#####.###.###.###.#######.#######.#.#.###.#.###.###.#.#  
  #.........#.........#...#.#.#.#.#.....#.#.....#...#.#.#.#...#.....#...........#.........#.#.#...#.#...#.#  
  #.#####.#.#.#####.###.###.#.#.#.#.#.###.#.#########.#.#.#.###.###.#####.###.#.#.#####.###.#.#######.###.#  
  #.#.#...#.#.#.#...#...#...#...#...#.....#.......#.......#.#.#.#...#.#...#.#.#...#.#.#.#...........#.#...#  
  ###.#.#######.#############.#####.#####.#.#####.#######.#.#.#.#####.###.#.###.###.#.#.###########.#.#.###  
  #...#...#.#.....#.......#.......#.#...#.#.#...#.#.#...#.#.#.....#...#...#...#...#...#...#...#...#.#.#...#  
  ###.#####.#####.#.#####.#.#####.#.#.#.###.#.#.#.#.###.#.#.#.#.###.###.###.#.#####.#######.###.#.###.###.#  
  #...#.................#.....#.#.#...#.#.#.#.#.#.#.......#.#.#.#.....#.....#...................#.#...#...#  
  #.#.###.###.###.#.#.#####.###.#.#.#.#.#.###.#.#.#.#######.###.###.#.#.#####.###.#########.#.#.###.#.###.#  
  #.#.....#...#...#.#...#.....#...#.#.#...#...#...#.......#...#.....#.#.#.......#.........#.#.#...#.#.#...#  
  #############################.#########.###.#########.#####.###.#######.###.#############################  
                               B         R   A         R     E   E       A   X                               
                               H         U   U         K     R   G       A   Z                               
